9 13
1 1 1 1 2 5 1 2 1 1 4 1 1
1 7 2 1 1 1 3 1 1 1 2 1 1
1 1 5 1 1 1 2 6 1 2 1 3 1
1 4 2 1 3 1 1 1 2 4 5 7 5
1 1 2 1 1 6 1 1 1 2 1 1 1
2 1 4 1 1 1 7 2 3 1 1 1 2
1 1 2 1 1 1 1 4 2 1 6 1 1
1 1 1 7 3 1 2 5 1 1 2 1 1
1 1 2 1 6 1 2 1 1 1 1 1 4